small: маленький
big: великий
country: країна
pupils: зіниці
our: наш
can: можна
library: бібліотека
are: знаходяться
school: школа
and: а також
find: знайти
of: з
have: мати
has: має
different: інший
newest: новітній
every: кожен
they: вони
you: ви
on: книги
new: новий
languages: мови
in: в
subjects: предмети
libraries: бібліотеки
come: приїхати
many: багато
take: приймати
books: книги
null: test
oldest: старший
everywhere: всюди
there: там
millions: мільйони
